TILEMAP
24 24 							-- Size of tile map in tiles
16 16 							-- Tile size & block size
images/tileset.png 	-- Tilesheet
16 16 								-- Number of tiles in tilesheet
AAAAAAAAAAAAAAAAAAAAAAAA
A                      A
A                      A
A                      A
A                      A
A                      A
A                      A
A                      A
A                      A
A                      A
AAAA                AAAA
AAAA                AAAA
A                      A
A                      A
A                      A
A                      A
A                      A
A                      A
A                      A
A                      A
A                      A
A                      A
A                      A
AAAAAAAADDDDDDDDAAAAAAAA



