TILEMAP
24 24 							-- Size of tile map in tiles
16 16 							-- Tile size & block size
images/cross.png    -- Background
images/tileset.png 	-- Tilesheet
16 16 								-- Number of tiles in tilesheet
AAAAAAAAAAAAAAAAAAAAAAAA
A  A  A  A  A  A  A  A A
A  A  A  A  A  A  A  A A
A  A  A  A  A  A  A  A A
A                      A
A     OP               A
AAA   _`             AAA
A                      A
A              OP      A
AAA            _`    AAA
A                      A
A                      A
AAA                  AAA
A      ab              A
A      qr              A
AAA                  AAA
A                      A
A                      A
AAA                  AAA
A                      A
A                      A
A                      A
A                      A
AAAAAAAAAAAAAAAAAAAAAAAA



