TILEMAP
24 24 							-- Size of tile map in tiles
16 16 							-- Tile size & block size
images/back_3.png    -- Background
images/tileset.png 	-- Tilesheet
16 16 								-- Number of tiles in tilesheet
CCCCCCCCCCCCCCCCCCCCCCCC
C?@?@?@?@?@?@?@?@?@?@?@C
C3434343434343434343434C
C343434343434343434GH34C
C343434343434343434WX34C
C3434343434343434343434C
C3434343434343434343434C
C3434343434343434343434C
C?@?@?@?@?@?@?@?@?@?@?@C
C7878787878787878787878C
C7878787878787878787878C
C7878787878787878787878C
C7878787878787878787878C
C7878787878787878787878C
C7878787878787878787878C
C?@?@?@?@?@?@?@?@?@?@?@C
C3434343434343434343434C
C3434343434343434343434C
C3434343434343434343434C
C3434343434343434343434C
C3434343434343434343434C
C3434343434343434343434C
C?@?@?@?@?@?@?@?@?@?@?@C
CCCDDDDDDDDDDDDDDDDDDCCC