TILEMAP
24 24 							-- Size of tile map in tiles
16 16 							-- Tile size & block size
images/back_2.png    -- Background
images/tileset.png 	-- Tilesheet
16 16 								-- Number of tiles in tilesheet
CCCCCCCCCCCCCCCCCCCCCCCC
C3434343434343434343434C
C3434343434343434343434C
C34343434      3434GH34C
C343434343434343434WX34C
C3434343434343434343434C
C3434343434343434343434C
C34343434      34343434C
C3434343434343434343434C
C3434343434343434343434C
C3434343434343434343434C
C34343434      34343434C
C3434343434343434343434C
C3434343434343434343434C
C3434343434343434343434C
C3434343434343434343434C
C3434343434343434343434C
C3434343434343434343434C
C3434343434343434343434C
C3434343434343434343434C
C3434343434343434343434C
C3434343434343434343434C
C3434343434343434343434C
CCCCCCCCCCCCCCCCCCCCCCCC

